        ########        
        ########        
 ###################### 
 #......########......# 
 #......########......# 
 #..################..# 
 #..#   ########   #..# 
 #..#   ########   #..# 
 #..#     #..#     #..# 
 #..#     #..#     #..#  
 #..#     #..#     #..# 
 #..#     #..#     #..# 
 #..#     #..#     #..# 
 #..#     #..#     #..# 
 #..#     #..#     #..# 
 #..#     #..#     #..# 
 #..#    ##..##    #..# 
##..##   ##..##   ##..##
##..##   ##..##   ##..##
 #..#    ##..##    #..# 
 #..#     #..#     #..# 
 #..#     #..#     #..# 
 #..#     #..#     #..# 
 #..#     #..#     #..# 
 #..#     #..#     #..# 
 #..#     #..#     #..# 
 #..#     #..#     #..# 
 #..#     #..#     #..# 
 #..#   ########   #..# 
 #..#   ########   #..# 
 #..################..# 
 #......########......# 
 #......########......# 
 ###################### 
        ########        
        ########        
